NO ./textures/no.xpm
SO ./textures/so.xpm
WE ./textures/we.xpm
EA ./textures/ea.xpm
F 0,167,170
C  0,0 1,0

111111
1E0001
111111
