NO ./textures/no.xpm
SO ./textures/so.xpm
WE ./textures/we.xpm
EA ./textures/ea.xpm

F 26,85,87
C 0,167,170

11111111111111111111
1Q111111111111111111
11111111111111111111
11111111111111111111
