NO ./textures/no.xpm
SO ./textures/so.xpm
WE ./textures/we.xpm
EA ./textures/ea.xpm

F 26,85,87
C 0,167,170

11111111111111111111
10000000000000000001
10011000000000001111
10011    00000000001
10000000000011001111
10000000000011000001
10000000000000000001
10000000000000000001
11111111111000000001
10000000001000000001
10000000001000000001
10000000001000000001
10000000001000000001
10000000001000000001
10000000001000000001
10000000000000000001
10111111111111111111
       101
111111111111111111N1
11111111111111111111
