NO ./textures/no.xpm
SO ./textures/so.xpm
WE ./textures/we.xpm
EA ./textures/ea.xpm

F 26,85,87
C 0,167,170

111111
1S0001
1N0001
111111
