NO ./textures/no.xpm
SO ./textures/so.xpm
WE ./textures/we.xpm
EA ./textures/ea.xpm
F 26,85,87
C 0,167,170

11111
1   1
1 E 1
1   1
11111
