NO ./textures/no.xpm
SO ./textures/so.xpm
WE ./textures/we.xpm
EA ./textures/ea.xpm

F 26,85,87
C 0,167,170

11111
10001
10N01
10001
11111
