NO ./textures/N_wall.xpm
SO ./textures/S_wall.xpm
WE ./textures/W_wall.xpm
EA ./textures/E_wall.xpm
C 178,255,255
F 52,140,49
11111111111      1111111
10001000001   1110000001111
10001000001  1000000001
10000000001   1110000001111
100N0000001      1111111
11111111111
