NO ./textures/N_wall.xpm
SO ./textures/S_wall.xpm
WE ./textures/W_wall.xpm
EA ./textures/E_wall.xpm
C 178,255,255
F 52,140,49
11111111111
100010000011
1000100000001
1000000000001   00
100N00000011
11111111111
