NO ./textures/mc/mossy_cobblestone.xpm
WE ./textures/mc/mossy_stone_bricks.xpm
SO ./textures/mc/stone.xpm
EA ./textures/mc/stone_bricks.xpm
F 90,90,95
C 100, 153, 233

111111111111111111111111111111111111111111111111111111
110000111100000000000000000000000000000100000000000001
100000000100001100000000000000000000000100111000000101
111110000100001010000000000000000000000100101000000101
111110000100001011001100110000110001100110100000011101
111110000100001010000000000000000000000010101000011101
100000000000001100000000000000000000000010000000000001
110000000000000000000000000000000000000000000000000001
111111111111100000111111110011111111000000000000000001
100000000000100000100000010010000001000000011000000001
101010100000100000101111010010111101000000001110000001
101111100000000010101001010010100101010000000011111111
100011000100000011101001010010100101110000000000000001
100011101100000011100000010010000001110000000000000001
100010000010100010100000000000000001010000000000000001
100010101010100000100000000000000001000000000000000001
100010000010100000100000010010000001000000100001000001
100010111010100000100000000000000001000000100001001001
100010000010100000100001000000100001000000100001001001
100011111110100000000001000000100000000001110001111101
100010010000100000000000111111000000000000100001000001
100011110000100000000000000000000000000000000001000001
100010010000100000000000000000000000001101100001001001
100010010000000000000111111111111000001001000000001001
100000101000000000101100000000001101001101100000000001
100001101100000000111000000000000111000000000000000001
100000000000100000000000000000000000000000000000000001
100000000000100000000000000000000000000000000000000001
111111100111111111000000000000000000111111111001111111
  10000000001    10000000000000000001    10000000001
  10000000001    10000000000000000001    10000000001
  10000000001    10000001100110000001    10000000001
  10000000001    11000010000001000011    10000000001
  10000000001     100010000000010001     10000000001
   100000001      100010000000010001      100000001
    1000001       110010000000010011       1000001
     11111         1111000000001111         11111
                     11110N001111
                        111111

