NO textures/ConcreteWall.xpm
WE textures/ConcreteWall.xpm
SO ./textures/WoodWall.xpm
EA ./textures/WoodWall.xpm
F 62,62,66
C 0,82,164

1111111111111111111111111111111111111
1100001111000000000000000010000000001
1000000001000011000111111111110011001
1111100001000010100001000000000000001
1100100001000010100101001100001100011
1000110001101000101000010000001000001
1000100100001000100110001111110000001
1000110100001000100001111110000011001
1000100100001000100000000000000100101
1000100100000000000001111111111110001
1000000010000000001011000000000011011
1000011011000000001110000000000001111
1000010000001000000000000000000000001
1000010000001000000000000111100000001
1100000000000111110000000000000000001
  10001110001    10000010000001000001
  10010000001    10000010000001000001
  10100001111    10000001100110000001
  10100100101    11001000000000010011
  10010100001     100010000000010001
   100111101      100010000000010001
    1000001       110010000000010011
     11111         1111000000001111
                     11110N001111
                        111111